證券代號,年季,　 營業收入,　　 營業收入合計,　 營業成本,　　 營業成本合計,　 營業毛利（毛損）,　 營業毛利（毛損）淨額,　 營業費用,　　 推銷費用,　　　 推銷費用合計,　　 管理費用,　　　 管理費用合計,　　 營業費用合計,　 營業利益（損失）,　 營業外收入及支出,　　 其他收入,　　　 其他收入合計,　　 其他利益及損失,　　　 其他利益及損失淨額,　　 財務成本,　　　 財務成本淨額,　　 營業外收入及支出合計,　 繼續營業單位稅前淨利（淨損）,　 所得稅費用（利益）,　　 所得稅費用（利益）合計,　 繼續營業單位本期淨利（淨損）,　 本期淨利（淨損）,　 本期綜合損益總額,　 基本每股盈餘,　　 基本每股盈餘合計,　 其他綜合損益(淨額),　　 確定福利計畫精算利益（損失）,　　 其他綜合損益（淨額）
2028,2015年第3季,,                695055,,                995650,               -300595,               -300595,,,                 14642,,                 16539,                 31181,               -331776,,,                 19023,,               -155681,,                 30715,               -167373,               -499149,,                 16202,               -515351,               -515351,               -515351,,                             -1.50,,,
2028,2015年第2季,,              1693469,,              1839771,               -146302,               -146302,,,                 31111,,                 19665,                 50776,               -197078,,,                    999,,                 -2660,,                 23929,                -25590,               -222668,,,               -222668,               -222668,               -222668,,                             -0.65,,,
2028,2015年01月01日至2015年09月30日,,              4521918,,              5093739,               -571821,               -571821,,,                 86940,,                 56301,                143241,               -715062,,,                 20697,,               -154155,,                 78638,               -212096,               -927158,,                 16202,               -943360,               -943360,               -943360,,                             -2.75,,,
2028,2015年01月01日至2015年06月30日,,              3826863,,              4098089,               -271226,               -271226,,,                 72298,,                 39762,                112060,               -383286,,,                  1674,,                  1526,,                 47923,                -44723,               -428009,,,               -428009,               -428009,               -428009,,                             -1.25,,,
2028,2015年01月01日至2015年03月31日,,              2133394,,              2258318,               -124924,               -124924,,,                 41187,,                 20097,                 61284,               -186208,,,                    675,,                  4186,,                 23994,                -19133,               -205341,,,               -205341,               -205341,               -205341,,                             -0.60,,,
2028,2014年第3季,,              2410319,,              2494530,                -84211,                -84211,,,                 30719,,                 22046,                 52765,               -136976,,,                    912,,                 -1863,,                 23011,                -23962,               -160938,,                              0,               -160938,               -160938,               -160938,,                             -0.57,,,
2028,2014年第2季,,              2496367,,              2610638,               -114271,               -114271,,,                 44826,,                 21564,                 66390,               -180661,,,                  1506,,                  1506,,                 20743,                -17731,               -198392,,,               -198392,               -198392,               -198392,,                             -0.75,,,
2028,2014年度,,             10009160,,             10263473,               -254313,               -254313,,,                172806,,                 97673,                270479,               -524792,,,                  5700,,                 -3799,,                 90172,                -88271,               -613063,,,               -613063,               -613063,               -607623,,                             -2.06,,                  5440,                  5440
2028,2014年01月01日至2014年09月30日,,              7434633,,              7640304,               -205671,               -205671,,,                127964,,                 71216,                199180,               -404851,,,                  4492,,                 -5648,,                 65299,                -66455,               -471306,,                              0,               -471306,               -471306,               -471306,,                             -1.67,,,
2028,2014年01月01日至2014年06月30日,,              5024314,,              5145774,               -121460,               -121460,,,                 97245,,                 49170,                146415,               -267875,,,                  3580,,                 -3785,,                 42288,                -42493,               -310368,,,               -310368,               -310368,               -310368,,                             -1.17,,,
2028,2014年01月01日至2014年03月31日,,              2527947,,              2535136,                 -7189,                 -7189,,,                 52419,,                 27606,                 80025,                -87214,,,                  2074,,                 -5291,,                 21545,                -24762,               -111976,,,               -111976,               -111976,               -111976,,                             -0.42,,,
2028,2013年第3季,,              2357386,,              2440820,                -83434,                -83434,,,                 29583,,                 25436,                 55019,               -138453,,,                  1569,,                 -9982,,                 20710,                -29123,               -167576,,                              0,               -167576,               -167576,               -167576,,                             -0.63,,,
2028,2013年第2季,,              2981478,,              2991760,                -10282,                -10282,,,                 48685,,                 24398,                 73083,                -83365,,,                  1584,,                 -3173,,                 19008,                -20597,               -103962,,                              0,               -103962,               -103962,               -103962,,                             -0.39,,,
2028,2013年度,,             10418424,,             10565922,               -147498,               -147498,,,                162507,,                 91044,                253551,               -401049,,,                195754,,                -68365,,                 80805,                 46584,               -354465,,,               -354465,               -354465,               -358710,,                             -1.34,,                 -4245,                 -4245
2028,2013年07月01日至2013年09月30日,,              2357386,,              2440820,                -83434,                -83434,,,                 29583,,                 25436,                 55019,               -138453,,,                  1569,,                 -9982,,                 20710,                -29123,               -167576,,                              0,               -167576,               -167576,               -167576,,                             -0.63,,,
2028,2013年04月01日至2013年06月30日,,              2981478,,              2991760,                -10282,                -10282,,,                 48685,,                 24398,                 73083,                -83365,,,                  1584,,                 -3173,,                 19008,                -20597,               -103962,,                              0,               -103962,               -103962,               -103962,,                             -0.39,,,
2028,2013年01月01日至2013年12月31日,,             10418424,,             10565922,               -147498,               -147498,,,                162507,,                 91044,                253551,               -401049,,,                195754,,                -68365,,                 80805,                 46584,               -354465,,                              0,               -354465,               -354465,               -358710,,                             -1.34,,                 -4245,                 -4245
2028,2013年01月01日至2013年09月30日,,              7656069,,              7705370,                -49301,                -49301,,,                112294,,                 73613,                185907,               -235208,,,                  3596,,                -24826,,                 59292,                -80522,               -315730,,                              0,               -315730,               -315730,               -315730,,                             -1.19,,,
2028,2013年01月01日至2013年06月30日,,              5298683,,              5264550,                 34133,                 34133,,,                 82711,,                 48177,                130888,                -96755,,,                  2027,,                -14844,,                 38582,                -51399,               -148154,,                              0,               -148154,               -148154,               -148154,,                             -0.56,,,
2028,2013年01月01日至2013年03月31日,,              2317205,,              2272790,                 44415,                 44415,,,                 34026,,                 23779,                 57805,                -13390,,,                    443,,                -11671,,                 19574,                -30802,                -44192,,                              0,                -44192,                -44192,                -44192,,                             -0.17,,,
2028,2012年07月01日至2012年09月30日,,              2139117,,              2128227,                 10890,                 10890,,,                 25610,,                 19890,                 45500,                -34610,,,                  3391,,                  6477,,                 20995,                -11127,                -45737,,                -16122,                -29615,                -29615,                -29615,,                             -0.11,,,
2028,2012年04月01日至2012年06月30日,,              2187198,,              2169997,                 17201,                 17201,,,                 13523,,                 19991,                 33514,                -16313,,,                    312,,                 -4665,,                 20616,                -24969,                -41282,,                              0,                -41282,                -41282,                -41282,,                             -0.15,,,
2028,2012年01月01日至2012年12月31日,,             10030624,,              9931781,                 98843,                 98843,,,                105580,,                 84838,                190418,                -91575,,,                  3200,,                129784,,                 81924,                 51060,                -40515,,                              0,                -40515,                -40515,                -58494,,                             -0.15,,                -17979,                -17979
2028,2012年01月01日至2012年09月30日,,              7243257,,              7158065,                 85192,                 85192,,,                 68880,,                 60327,                129207,                -44015,,,                  4323,,                 -8527,,                 62121,                -66325,               -110340,,                -16122,                -94218,                -94218,                -94218,,                             -0.36,,,
2028,2012年01月01日至2012年06月30日,,              5104140,,              5029838,                 74302,                 74302,,,                 43270,,                 40437,                 83707,                 -9405,,,                    932,,                -15004,,                 41126,                -55198,                -64603,,                              0,                -64603,                -64603,                -64603,,                             -0.24,,,
2028,2012年01月01日至2012年03月31日,,              2916942,,              2859841,                 57101,                 57101,,,                 29747,,                 20446,                 50193,                  6908,,,                    621,,                -10340,,                 20510,                -30229,                -23321,,,                -23321,                -23321,                -23321,,                             -0.09,,,
